Points : 

Dicatation	: Value
equals		: =

Backup Functions: 

//var cursor = editor.getCursor(); // gets the line number in the cursor position
            //var line = editor.getLine(cursor.line); // get the line contents
            //var pos = { // create a new object to avoid mutation of the original selection
            //    line: cursor.line,
            //    //ch: line.length // set the character position to the end of the line
            //    //ch: 0, // To the start
            //    ch: cursor.ch
            //}

//editor.replaceRange('<' + arg + '></' + arg + '>', pos); // adds a new line
            //golineup();
            //selectline();
            //formathtml();


//Templte

var  = function () {
            editor.execCommand("");
        }


singleselection: singleselection,
killline: killline,
deleteline: deleteline,
dellineleft: dellineleft,
delwrappedlineleft: delwrappedlineleft,
delwrappedlineright: delwrappedlineright,
undoselection: undoselection,
redoselection: redoselection,
golinestart: golinestart,
home: golinestart,
smarthome: golinestartsmart,
controlhome: godocstart,
controlend: godocend,
golineend: golineend,
end: golineend,
golineright: golineright,
golineleft: golineleft,
golineleftsmart: golineleftsmart,
golineup: golineup,
uparrow: golineup,
golinedown: golinedown,
downarrow: golinedown,
gopageup: gopageup,
pageup: gopageup,
gopagedown: gopagedown,
pagedown: gopagedown,
gocharleft: gocharleft,
leftarrow: gocharleft,
gocharright: gocharright,
rightarrow: gocharright,
gocolumnleft: gocolumnleft,
gocolumnright: gocolumnright,
gowordleft: gowordleft,
controlleftarrow: gowordleft,
gowordright: gowordright,
controlrightarrow: gowordright,
goGroupLeft: goGroupLeft,
gogroupright: gogroupright,
delcharbefore: delcharbefore,

delcharafter: delcharafter
deletes: delcharafter,
defaulttab: defaulttab,
tab: defaulttab,
delwordafter: delwordafter,
delgroupbefore: delgroupbefore,
delgroupafter: delgroupafter,
indentauto: indentauto,
indentmore: indentmore,
indentless: indentless,
insertsofttab: insertsofttab,
transposechars: transposechars,
newlineandindent: newlineandindent,
toggleoverwrite: toggleoverwrite,

formathtml: formathtml,

openparenthesis: openparenthesis,
openparentheses: openparenthesis,
openbracket: openparenthesis,
closeparenthesis: closeparenthesis,
closeparentheses: closeparenthesis,
closebracket: closeparenthesis

selectelement: selectelement,
editelement: editelement,
addattribute:addattribute,
appendelement: appendelement

singlequote:singlequote,
singlequotes: singlequotes,
doublequote: doublequote,
doublequotes: doublequotes

addmetaresponsive: addmetaresponsive

movelineup: movelineup,
movelinedown: movelinedown